NO ./textures/wolftextures1.png
SO ./textures/wolftextures2.png
WE ./textures/wolftextures3.png
EA ./textures/wolftextures4.png

F 255,0,0
C 0,0,255

11111
10001
10001
10W01
11111
