NO ./textures/wolftextures1.png
SO ./textures/wolftextures2.png
WE ./textures/wolftextures3.png
EA ./textures/wolftextures4.png

F 120,100,50
C 105,150,150

11111
10011
10001
10E01
11111