NO ./textures/wolftextures1.png
SO ./textures/wolftextures2.png
WE ./textures/wolftextures3.png
EA ./textures/wolftextures4.png

F 25,165,189
C 105,150,150

11111
1N011
10001
10001
11111