WE images/1.xpm
EA images/2.xpm

F  141,        111,      126 	

C     0        ,183      ,183

SO                   images/3.xpm
NO images/4.xpm

 111111
1100W00011
11111111