NO ./textures/wolftextures1.png
SO    ./textures/wolftextures2.png
WE   ./textures/wolftextures3.png
EA  ./textures/wolftextures4.png

C                64,128,192
F 32,128,64


111111111111111111111111111111111111111111111111111
100000010001000000010000000001000010000000000000001
100000011011000000000001000001000010000000000000001
100000000000000000011111111111110111111111111111111
101100000000000000000000000000000010000000000000001
101000011011111111111111110001111111111111111111111
1000001000001           1000001
111000100N001         11101110111
1111111111111         10000000001
                      11111111111
