NO ./textures/wolftextures1.png
SO    ./textures/wolftextures2.png
WE   ./textures/wolftextures3.png
EA            ./textures/wolftextures4.png

C                64,128,192
F 32,128,64

1111111111111
1000000001111
1000000000111
1E0000000000111111111111111111111111111111111111111
101100000000000000000000000000000000000000000000001
101000011011111111111111111111111111111111111111111
1000001000001
1110001000001 
1111111111111